┌──────────────┐
│              │
│      ╷       │
│     ╶┼─┬┬╴┌╴ │
├──────┘ ├┴─┤  │
│        ╵  └╴ │
│              │
│              │
│              │
│              │
│              │
│              │
│              │
│              │
│              │
└──────────────┘